20,100,,,,,,,,,,,,,,,,,,,
1,,,,,,,,,,,,,,,,,,,,1
1,,,,,,,,,,,,,,,,,,,,1
1,,,,,,,,,,,,,,,,,,,,1
1,,,,,,,,,,,,,,,,,,,,1
1,,,,,,,,,,,,,,,,,,,,1
1,,,,,,,,,,,,,,,,,,,,1
1,,,,,,,,,,,,,,,,,,,,1
1,,,,,,,,,,,,,,,,,,,,1
1,,,,,,,,,,,,,,,,,,,,1
1,,,,,,,,,,,,,,,,,,,,1
1,,,,,,,,,,,,,,,,,,,,1
1,,,,,,,,,,,,,,,,,,,,1
1,,,,,,,,,,,,,,,,,,,,1
1,,,,,,,,,,,,,,,,,,,,1
1,,,,,,,,,,,,,,,,,,,,1
1,,,,,,,,,,,,,,,,,,,,1
1,,,,,,,,,,,,,,,,,,,,1
1,,,,,,,,,,,,,,,,,,,,1
1,,,,,,,,,,,,,,,,,,,,1
1,,,,,,,,,,,,,,,,,,,,1
1,,,,,,,,,,,,,,,,,,,,1
1,,,,,,,,,,,,,,,,,,,,1
1,,,,,,,,,,,,,,,,,,,,1
1,,,,,,,,,,,,,,,,,,,,1
1,,,,,,,,,,,,,,,,,,,,1
1,,,,,,,,,,,,,,,,,,,,1
1,,,,,,,,,,,,,,,,,,,,1
1,,,,,,,,,,,,,,,,,,,,1
1,,,,,,,,,,,,,,,,,,,,1
1,,,,,,,,,,,,,,,,,,,,1
1,,,,,,,,,,,,,,,,,,,,1
1,,,,,,,,,,,,,,,,,,,,1
1,,,,,,,,,,,,,,,,,,,,1
1,,,,,,,,,,,,,,,,,,,,1
1,,,,,,,,,,,,,,,,,,,,1
1,,,,,,,,,,,,,,,,,,,,1
1,,,,,,,,,,,,,,,,,,,,1
1,,,,,,,,,,,,,,,,,,,,1
1,,,,,,,,,,,,,,,,,,,,1
1,,,,,,,,,,,,,,,,,,,,1
1,,,,,,,,,,,,,,,,,,,,1
1,,,,,,,,,,,,,,,,,,,,1
1,,,,,,,,,,,,,,,,,,,,1
1,,,,,,,,,,,,,,,,,,,,1
1,,,,,,,,,,,,,,,,,,,,1
1,,,,,,,,,,,,,,,,,,,,1
1,,,,,,,,,,,,,,,,,,,,1
1,,,,,,,,,,,,,,,,,,,,1
1,,,,,,,,,,,,,,,,,,,,1
1,,,,,,,,,,,,,,,,,,,,1
1,,,,,,,,,,,,,,,,,,,,1
1,,,,,,,,,,,,,,,,,,,,1
1,,,,,,,,,,,,,,,,,,,,1
1,,,,,,,,,,,,,,,,,,,,1
1,,,,,,,,,,,,,,,,,,,,1
1,,,,,,,,,,,,,,,,,,,,1
1,,,,,,,,,,,,,,,,,,,,1
1,,,,,,,,,,,,,,,,,,,,1
1,,,,,,,,,,,,,,,,,,,,1
1,,,,,,,,,,,,,,,,,,,,1
1,,,,,,,,,,,,,,,,,,,,1
1,,,,,,,,,,,,,,,,,,,,1
1,,,,,,,,,,,,,,,,,,,,1
1,,,,,,,,,,,,,,,,,,,,1
1,,,,,,,,,,,,,,,,,,,,1
1,,,,,,,,,,,,,,,,,,,,1
1,,,,,,,,,,,,,,,,,,,,1
1,,,,,,,,,,,,,,,,,,,,1
1,,,,,,,,,,,,,,,,,,,,1
1,,,,,,,,,,,,,,,,,,,,1
1,,,,,,,,,,,,,,,,,,,,1
1,,,,,,,,,,,,,,,,,,,,1
1,,,,,,,,,,,,,,,,,,,,1
1,,,,,,,,,,,,,,,,,,,,1
1,,,,,,,,,,,,,,,,,,,,1
1,,,,,,,,,,,,,,,,,,,,1
1,,,,,,,,,,,,,,,,,,,,1
1,,,,,,,,,,,,,,,,,,,,1
1,,,,,,,,,,,,,,,,,,,,1
1,,,,,,,,,,,,,,,,,,,,1
1,,,,,,,,,,,,,,,,,,,,1
1,,,,,,,,,,,,,,,,,,,,1
1,,,,,,,,,,,,,,,,,,,,1
1,,,,,,,,,,,,,,,,,,,,1
1,,,,,,,,,,,,,,,,,,,,1
1,,,,,,,,,,,,,,,,,,,,1
1,,,,,,,,,,,,,,,,,,,,1
1,,,,,,,,,,,,,,,,,,,,1
1,,,,,,,,,,,,,,,,,,,,1
1,,,,,,,,,,,,,,,,,,,,1
1,,,,,,,,,,,,,,,,,,,,1
1,,,,,,,,,,,,,,,,,,,,1
1,,,,,,,,,,,,,,,,,,,,1
1,,,,,,,,,,,,,,,,,,,,1
1,,,,,,,,,,,,,,,,,,,,1
1,,,,,,,,,,,,,,,,,,,,1
1,,,,,,,,,,,,,,,,,,,,1
1,,,,,,,,,,,,,,,,,,,,1
1,,,S,,,,14,,,,,,,,,,,,,1
1,1,1,1,1,1,1,1,1,1,1,1,1,1,1,1,1,1,1,1,1
