31,100
1,1,1,1,1,1,1,1,1,1,1,1,1,1,1,1,1,1,1,1,1,1,1,1,1,1,1,1,1,1,1
1,,,,,,,,,,,,,,,,,,,,,,,,,,,,,,1
1,,,,,,,,,,,,,,,,,,,,,,,,,,,,,,1
1,,,,,,,,12,,,,,,,,,,,,,12,,,,,,,,,1
1,,,,,,,,,,,,,,,,,,,,,,,,,,,,,,1
1,,,,10,10,10,10,10,10,10,10,10,10,10,10,10,10,10,10,10,10,10,10,10,10,10,,,,1
1,,,,2,2,2,2,2,2,2,2,2,2,2,2,2,2,2,2,2,2,2,2,2,2,2,,,,1
1,,,,,,,2,2,2,2,2,2,2,2,2,2,2,2,2,2,2,2,2,2,,,,,,1
1,,,,,,,,,,2,2,2,2,2,2,2,2,2,2,2,2,,,,,,,,,1
1,,,,,,,,,,,,,2,2,2,2,2,2,,,,,,,,,,,,1
1,,,,12,,,,,,,,,,,,,,,,,,,,,,,,,,1
1,,,,,,,,,,,,,12,,,,,,,,,,,,,,,,,1
1,,,,,,,,,,,,,,,,,,,,,,,,,,,,,,1
1,,,,,,,,,,,,,,,,,,,,,,,,,,,,,,1
1,,4,4,4,4,4,4,4,4,4,,,,,,,,,,,,,,,,,,,,1
1,,,4,4,4,4,4,4,4,,,,,,,,,,,,,,,,,,,,,1
1,,,,,,,,,,,,,,,,,,,,,,,,,,,,,,1
1,,,,,,,,,,,,,,,,,,,,,,,,,,,,,,1
1,,,,,,,12,,,,,,,,,,,,,,,,,12,,,,,,1
1,,,,,,,,,,,,,,,,,,,,,,,10,10,10,10,,,,1
1,,,,,,,,,,,,,,,,,,,,,,,2,2,2,2,,,,1
1,,,,,,,,,,,,,,,,,,,,,,,,2,2,,,,,1
1,,,,,,,,,,,,,,,12,,,,,,,,,,,,,,,1
1,,,,,,,,,,,,,,10,10,10,10,,,,,,12,,,,,,,1
1,,,,,,,,,,,,,,2,2,2,2,,,,,,,,,,,,,1
1,,,,,,12,,,,,,,,,2,2,,,,,,,,,,,,,,1
1,,,,,,,,,,,,,,,,,,,,,,,,,,,,,,1
1,,,,,,,,,,,,,,,,,,,2,2,2,2,2,9,,12,,,,1
1,,,,,,,,,,,,,,,,,,2,2,2,2,2,11,,,,,,,1
1,,,,,,,,,,,,,,,,,2,2,2,2,2,11,,,,,,,,1
1,,,2,2,2,2,,,,,,,,,,,11,11,11,11,11,,,,,,,,,1
1,,,,2,2,,,,,,,,,,,,,,,,,,,,,,,,,1
1,,,,,,,,,,,,12,,,,,,,,,,,,,12,,,,,1
1,,,,,,,,,,,,,,,,,,,,,,,,,,,,,,1
1,,,,,,,,,,,2,2,2,2,2,,,,,,,10,10,10,10,,,,,1
1,,,,,,,,,,,,,2,2,2,2,,,,10,10,2,2,2,2,10,,,,1
1,,,,,,,,,,,,,,,2,,,,,2,2,2,2,2,2,2,,,,1
1,,,,,,,,,,,,,,,,,,,,2,2,2,2,2,,,,,,1
1,,,,,,,,,,,,,,,,,,,,,2,2,,,,,,,,1
1,,,,,,,,,,,,,,,,,,,,,,,,,,,,,,1
1,,,,,,,12,,,,,,,,,,,,,,,,,,,,,,,1
1,,,,,,,,,,,,,,,,,,,,,,,,,,,,,,1
1,,,,,,,,,,,,,,,,,,,,,,,4,4,4,4,4,4,,1
1,,,,,,,,,,,,,,,,,,,,,,,,4,4,4,4,,,1
1,,,,,12,,,,,,,,,,,,,,,,,,,,,,,,,1
1,,,,,,,,,,,,,,,,,,,,,,,,,,,,,,1
1,,,,,,,,,,,,12,,,,,,,,,,,,,,,,,,1
1,,,,,,,,,,,,,,,,,,,,,,,,,,,,,,1
1,,,,,,,,,,,,,,,,,,,,,,,,,,,,,,1
1,,,,,,,,,,,,,2,2,2,2,2,2,2,9,,,,12,,,,,,1
1,,,,,,,,,,,2,2,2,2,2,2,2,11,11,,,,,,,,,,,1
1,,,,,,,,,,2,2,2,2,2,11,11,11,,,,,,,,,,,,,1
1,,,,,,,2,2,2,2,2,2,2,11,,,,,,,,,,,,,,,,1
1,,,,,,,11,11,2,2,11,11,11,,,,,,,,,,,,,,,,,1
1,,,,,,,,,11,11,,,,,,,,,,,,,,,,,,,,1
1,,,,,,,,,,,,,,,,,,,,,,,,,,,,,,1
1,,,,,,,,,12,,,,,,,,,,,,,,12,,8,2,2,2,2,1
1,,,,4,4,4,,,,,,,,8,2,2,2,2,2,2,,,,,,11,2,2,11,1
1,,,,4,4,4,,,,,,,,8,2,2,2,2,2,11,,,,,,,11,11,,1
1,,,,4,4,4,,,,,,,,,11,2,2,11,11,,,,,,,,,,,1
1,,,,,,,,,,,,,12,,,11,11,,,12,,,,,,,,,,1
1,,,,,,,,,,,,,,,,,,,,,,,,,,,,,,1
1,,,,,,,,,,,,,,,,,,,,,,,,,,,,,,1
1,,,,,,,,12,,,,,,,,,,,,,,,,,,,,,,1
1,,,,,,,10,10,10,10,10,10,10,,,,,,,,,,,,,,,,,1
1,,,,,,,2,2,2,2,2,2,2,,,,,,,,2,2,2,2,,,,,,1
1,,,,,,,,,2,2,2,2,,,,,,2,2,2,2,2,11,11,,,,,,1
1,,,,,,,,,,,2,,,,,,,2,2,2,11,11,,,,,,,,1
1,,,,,,,,,,,,,,,,,,2,11,11,,,,,,,,,,1
1,,,,,,,,12,,,,,,,,,,11,,12,,,,,,,,,,1
1,,,,,,,,,,,,,,,,,,,,,,,,,,,,,,1
1,,,4,4,,,,,,,,,,,,,,,,,,,,,,4,4,,,1
1,,,,,,,,,,,,,,,,,,,,,,,,,,,,,,1
1,,,,,,,,,,,,,,,,,,,,,,,,,,,,,,1
1,,,,,,,,12,,,,,,4,4,4,4,,,,,,,,,,,,,1
1,,,,,,,,,,,,,,4,4,4,4,,,,,,,,,,,,,1
1,,,,,,,,,,,,,,4,4,4,4,,,,,,12,,,,,,,1
1,2,2,2,2,2,2,2,2,,,,,,,,,,,,,,,,,,,,,,1
1,2,2,2,2,2,2,2,,,,,,,,12,,,,,,,,2,2,2,2,2,2,2,1
1,,2,2,2,2,,,,,,,,,,,,,,,,,,,2,2,2,2,2,2,1
1,,,,,,,,,,,,,,,,,,,,,,,,,,2,2,2,2,1
1,,,,,,,,,,,,,,,,,,,,,,,,,,,,2,2,1
1,,,,,,,,,,,,,,,,,,,,,,,,,,,,,,1
1,,,,,,,,,,,,2,2,2,2,2,2,2,2,2,,,,,,,,,,1
1,,,,,,,,,,,,2,2,2,2,2,2,2,2,,,,12,,,,,,,1
1,,,,,,,,,,,,,,2,2,2,2,,,,,,,,,,,,,1
1,,,,,,,,,,,,,,,2,,,,,,,,,,,,,,,1
1,,,,,,12,,,,,,,,,,,,,,,,,,,,,,,,1
1,,,,,,,,,,,,,,,,,,,,,,,,,,,,,,1
1,,,,,,,,,,,,,,,,,,,,,,,,,,,,,,1
1,,,,,,,,,,,,,,12,,,,,,2,2,2,2,2,2,,,,,1
1,,2,2,2,2,2,,,,,,,,,,,,,,,2,2,2,2,,,,,,1
1,,,2,2,2,,,,,,,,,,,,,,,,,,,,,,,,,1
1,,,,,,,,,,,,,,12,,,,,,,,,,,,,,,,1
1,,,,,,,,,,,,,,,,,,,,,,,,,,,,,,1
1,,,,,,,,,,,,,,,,,,,,,,,,,,,,,,1
1,,,,,,,,,,,,,,,,,,,,,,,,,,,,,,1
1,,,,s,,,,,,sp,,,,,,,,,s,,,,,,s,,,,,1
1,,,,,,,,,,,,,,,,,,,,,,,,,,,,,,1
1,1,1,1,1,1,1,1,1,1,1,1,1,1,1,1,1,1,1,1,1,1,1,1,1,1,1,1,1,1,1
